AA|ATARIA
AAG|ANGAR
AAH|ITEHAR
AAK|ANKAIKILA
AAL|AMLAI
AAR|ADESAR
AAS|ASRANADA
AAY|ARALVAYMOLI
AB|AMBUR
ABD|AMBLI ROAD
ABFC|AMBARI FALAKATA
ABH|AMBARNATH
ABI|AMBATURAI
ABKA|AMBIKA KALNA
ABKP|AMBIKAPUR
ABLE|AMBALE
ABP|AKBARPUR
ABR|ABU ROAD
ABS|ABOHAR
ABSA|AMBASSA
ABY|AMBIVLI
ACG|ACHEGAON
ACND|A N DEV NAGAR
AD|ADONI
ADB|ADILABAD
ADH|ANDHERI
ADI|AHMADABAD 
ADR|MANDI ADAMPUR
ADRA|ADRA 
ADT|ADUTURAI
ADTL|ADHARTAL
ADTP|ADITYAPUR
ADVI|ADAVALI
AED|AULENDA
AF|AGRA FORT
AFK|ANGAMALI
AFR|ASAFPUR
AGA|AGRA CITY
AGC|AGRA CANTT
AGI|AMGURI
AGL|AMARGOL
AGN|AMGAON
AGQ|ASIRGARH ROAD
AGR|AMARGARH
AGTL|AGARTALA
AGY|AGORI KHAS
AH|ACHHNERA 
AHA|ABHAIPUR
AHH|AHMADGARH
AHI|ASHTI
AHQ|AHERA HALT
AI|ADIPUR
AIG|ALGAWAN
AII|AJMER
AIR|ALINDRA ROAD
AIT|AIT
AJE|ANJAR
AJH|AJHAI
AJI|ANJHI SHAHABAD
AJJ|ARAKKONAM
AK|AKOLA 
AKD|AKODIA
AKE|AKANAPET
AKI|ADARKI
AKJ|AKBARGANJ
AKN|AKBARNAGAR
AKOR|AKALKOT ROAD
AKP|ANAKAPALLE
AKR|AKOLNER
AKRD|AKURDI
AKT|AKALTARA
AKV|ANKLESHWAR 
AKVD|AKIVIDU
AL|ATTILI
ALB|ALIA BADA
ALD|ALLAHABAD 
ALER|ALER
ALLP|ALLEPPEY
ALN|ALANDI
ALNI|ALNIYA
ALU|ARIYALUR
ALY|ALLAHABAD CITY
AMB|AMBODALA
AME|AMETHI
AMG|ALAMNAGAR
AMH|AZAMGARH
AMI|AMRAVATI
AML|AMALSAD
AMLA|AMLA 
AMLI|AMLI
AMM|ATIRAMPATTINAM
AMOD|AMOD
AMP|AHMADPUR 
AMPA|AMBALA PUZHA
AMRO|AMROHA
AMSA|AMMASANDRA
AN|AMALNER
ANA|ASLANA
ANAS|ANAS
ANB|AMMANABROLU
ANDI|NEW ADRESHNAGARH
ANDN|ANAND NAGAR
ANG|AHMADNAGAR
ANGL|ANGUL
ANH|ANKORAH AKORHA
ANK|ANKAI
ANKL|ANKOLA
ANND|ANAND 
ANPR|ANPARA
ANR|ANARA
ANSB|ANANDPUR SAHIB
ANTU|ANTU
ANV|ANNAVARAM
ANVR|ANAND VIHAR
ANVT|ANAND VIHAR TRML
ANY|ARUMUGANERI
AO|AONLA
APDJ|ALIPUR DUAR 
APN|AYODHYAPATTANAM
APR|ANUPPUR 
APT|ANAPARTI
APTA|APTA
AQG|ASHAPURA GOMAT
ARA|ARA
ARD|AMARDA ROAD
ARE|ARNETHA
ARJ|AUNRIHAR 
ARQ|ARARIYA COURT
ARW|AHRAURA ROAD
ASAF|ASIFABAD ROAD
ASH|AISHBAGH
ASK|ARSIKERE 
ASKN|ASHOK NAGAR
ASN|ASANSOL 
ASO|ASANGAON
ASR|AMRITSAR 
AST|ASAOTI
ASV|ASARVA 
ATE|ATARRA
ATG|ATGAON
ATH|ANTAH
ATL|ATHMAL GOLA
ATMO|AITHAL
ATNR|AWATARNAGAR
ATP|ANANTAPUR
ATQ|ARANTANGI
ATRU|ATRU
ATS|ATTABIRA
ATT|ATARI
ATU|ATTUR
AUB|ALUABARI ROAD
AUBR|ANUGRAHA N ROAD
AV|ASVALI
AVD|AVADI
AVN|ANAVARDIKHANPET
AWB|AURANGABAD
AWR|ALWAR
AWY|ALWAYE
AXK|ASOKHAR
AY|AYODHYA
AYRN|AKSHAYWAT RAI NAGAR
AZ|AZIMGANJ 
AZR|AZAMNAGAR ROAD
BAB|BABINA
BAD|BAD
BAF|BAP
BAGL|BARA GOPAL
BAH|BHABHAR
BAKA|BANKA
BAL|BUDALUR
BALE|BALE
BALU|BALUGAN
BAM|BERHAMPUR
BAMA|BIRAMBAD
BAND|BANASWADI
BANE|BASNI
BANI|BANI
BANO|BANO
BAO|BANMOR
BAP|BELAPUR
BAQ|GANJ BASODA
BARD|DUVRI KALAN
BARH|BARH
BARL|BARAL
BAT|BATALA 
BATL|BAIHATOLA
BAU|BURHANPUR
BAY|BELLARY 
BAZ|BARAN
BBA|BABRALA
BBK|BARABANKI 
BBM|BARABHUM
BBMN|BARI BRAHMAN
BBN|BARBIL
BBS|BHUBANESWAR
BBU|BHABUA ROAD
BBV|BABHULGOAN
BBY|BHADROLI
BC|BAREILLY CITY
BCA|BACHWARA 
BCH|BERCHHA
BCN|BACHHRAWAN
BCOB|BHACHAU BG
BCRD|BARCHHI ROAD
BCT|MUMBAI CENTRAL
BCU|BHUCHCHU
BCY|VARANASI CITY
BD|BADNERA 
BDBA|BADABANDHA ROAD
BDC|BANDEL 
BDH|BHEDIA
BDHY|BUDHI
BDI|BHADLI
BDJ|BADAGARA
BDL|VINDHYACHAL
BDM|BADAMI
BDME|BAIDYANATHDHAM
BDN|BHADAN
BDTS|BANDRA TERMINUS
BDU|BADNAPUR
BDVT|BHADRAVATI
BDWA|BADHWA BARA
BDWD|BODWAD
BDY|BUDDIREDDIPPATI
BE|BAREILLY
BEA|BIHIYA
BEAS|BEAS
BEB|BELDANGA
BEG|BEHTAGOKUL
BEH|BAGDIHI
BEHR|BEOHARI
BEHS|BIHAR SHARIF
BEK|BUNDKI
BELA|BELA
BEM|BUDAUN
BER|BEAWAR
BET|BARETH
BEY|B CEMENT NAGAR
BFD|BORHAT
BFJ|BHORAS BUDRUKH
BFM|BHALUI
BFP|BILOCHPURA AGRA
BG|BHONGIR
BGBR|BAGBAHRA
BGH|BAGHAULI
BGHI|BAGHAI ROAD
BGK|BAGALKOT
BGM|BELGAUM
BGN|BORGAON
BGP|BHAGALPUR
BGQ|BHONGAON
BGS|BEGU SARAI
BGSF|BISUGIRSHARIF
BGTA|BAGRA TAWA
BGUA|BAIGUDA
BGVN|BHIGWAN
BGWD|BAGEWADI
BGZ|BAHADURGARH
BH|BHARUCH 
BHB|BADLA GHAT
BHBK|BODHADI BUJRUG
BHC|BHADRAKH
BHD|BADLI
BHI|BAHERI
BHKD|BHURKUNDA
BHL|BHILWARA
BHLE|BARAHAT
BHLK|BHALKI
BHLP|BHULANPUR
BHME|BHANDARIDAH
BHP|BOLPUR S NIKTN
BHS|VIDISHA
BHT|BHATTU
BHTA|BHATIYA
BHTK|BHANWAR TONK
BHTN|BHITONI
BHTR|BHATPAR RANI
BHUJ|BHUJ
BHW|BARHARWA 
BIA|BHILAI
BID|BIDADI
BIDR|BIDAR
BIF|BHAIRONPUR
BIG|BELGAHNA
BIH|BAIRAGARH
BIJR|BIJOOR HALT
BIK|BHIRA KHERI
BILD|BILDI
BIM|BILIMORA 
BIML|BHIMAL
BINA|BINA 
BIO|BORDI
BIQ|BANSI PAHARPUR
BIR|BIR
BIRD|BHIWANDI ROAD
BIS|BISWA BRIDGE
BIWK|BISALWAS KALAN
BIX|BHIND
BIY|BARDOLI
BJ|BAHJOI
BJD|BAREJADI
BJE|BHOJUDIH 
BJF|BII
BJG|BAJRANGARH
BJK|BIJORA
BJMD|BARA JAMDA
BR|BIJAINAGAR
BJO|BIOR
BJP|BIJAPUR
BJQ|BAGHORA
BJR|BARRAJPUR
BJRI|BIJURI
BJU|BARAUNI 
BJV|BIJAURIA
BJW|BAJVA
BKG|BANKA GHAT
BKH|BANKHEDI
BKI|BANDIKUI 
BKJ|BARKUR
BKL|BONA KALU
BKN|BIKANER 
BKNG|BHAKTI NAGAR
BKO|BINDKI ROAD
BKP|BAKHTIYARPUR 
BKRD|BHALUKA ROAD F
BKRL|BAKROL
BKRO|BOKARO THERMAL
BKSC|BOKARO STL CITY
BKSL|BIKRAM SHILA(HALT)
BKT|BAKSHI KA TALAB
BL|VALSAD
BLAX|BARLAI
BLD|BHILAD
BLDA|BELDA
BLDI|BHILDI
BLG|BILHAR GHAT
BLGR|BALANGIR
BLGT|BALURGHAT
BLK|BELAKOBA
BLM|BALAMU 
BLMK|BHALUMASKA
BLND|BOLINNA DOABA
BLNI|BHALWANI
BLNR|BIRLANAGAR
BLO|BHULON
BLP|BALRAMPUR
BLPU|BILPUR
BLQR|BILASPUR ROAD
BLS|BALASORE
BLSA|BOLSA
BLT|BALOTRA 
BLTR|BELTHARA ROAD
BLU|BILHAUR
BLW|BALAWALI
BLZ|BUDHLADA
BMA|BAGMAR
BMB|BAMRA
BMD|BHIMADOLU
BME|BARMER
BMH|BETAMCHERLA
BMI|BAMNIA
BMLL|BAMLA
BMO|BOLARUM
BMR|BIKRAMPUR
BMSB|BHIMASAR BG
BMT|BEGAMPET
BMU|BAMHRAULI
BN|BIBINAGAR
BNBH|BANI BIHAR
BNC|BANGALORE CANT
BNCE|BANGALORE EAST
BNDA|BANDA 
BNDI|BARUNDINI
BNDM|BONDAMUNDA
BNDP|BUNIADPUR
BNE|BOHANI
BNGN|BONGAIGAON
BNI|BUDNI
BNLW|BANSTHALI NIWAI
BNN|BARNALA
BNO|BANAR
BNP|BHANAPUR
BNQ|BANARHAT
BNR|BHAGWANPUR
BNT|BHARTHANA
BNTL|BANTAWALA
BNU|BANDAKPUR
BNV|BINNAGURI
BNVD|BHAUNRA
BNW|BHIWANI
BNWC|BHIWANI CITY
BNXR|BIDHAN NAGAR
BNY|BARHNI
BNZ|BADSHAHNAGAR
BOD|BANGROD
BOE|BARSOI 
BOG|BHAIRONGARH
BOJ|BHOJO
BOK|BORKHEDI
BOKR|BHOKAR
BON|BHOnra
BONA|BOINDA
BOR|BOISAR
BOTI|BAORI THIKRIA
BOY|BHADOHI
BP|BARRACKPORE
BPA|BELAMPALLI
BPC|BERHAMPORE CRT
BPF|BANAPURA
BPH|BELPAHAR
BPHB|BHILAI PWR HS
BPK|BHUGAON
BPL|BHOPAL  
BPM|BAGPAT ROAD
BPO|BARIPADA
BPP|BAPATLA
BPQ|BALHARSHAH
BPR|BHOJIPURA 
BPRD|BARPETA ROAD
BPRH|BALPUR HALT
BQA|BANKURA
BQI|BOMMIDI
BQM|BARELIPAR
BQQ|BAKHLETA
BQR|BHILAINAGAR
BRAG|BARANG
BRB|BORIBIAL
BRC|VADODARA 
BRD|BHANDARA ROAD
BRE|BHARWARI
BRG|BARGARH
BRGA|BARGARH ROAD
BRGT|BHERAGHAT
BRGW|BARGAWAN
BRH|BAIKUNTHPUR RD
BRI|BHIRINGI
BRK|BAHRAICH
BRKA|BARKA KANA
BRLA|BRAYLA CHAURASI
BRMO|BERMO
BRMT|BARAMATI
BRNA|BERAWANYA
BRND|BORIDAND .
BRPL|BARPALI
BRPT|BIRAPATTI
BRR|BARAKAR
BRRG|BIYAVRA RAJGARH
BRS|BIRSINGHPUR
BRU|BHAIROGANJ
BRUD|BARUD
BRVR|BORVIHIR
BRWD|BARWADIH 
BRY|BAREILLY
BRYA|BARHIYA
BRZ|BARETA
BSB|VARANASI 
BSC|BULANDSHAHR
BSDL|BHARSENDI
BSDP|BHUSANDPUR
BSE|BADSHAHPUR
BSGN|BASUGAON
BSJ|BHUPALSAGAR
BSL|BHUSAVAL 
BSP|BILASPUR 
BSPN|BASSI PATHANAM
BSPR|BISHRAMPUR
BSQP|BANSIPUR
BSR|VASAI ROAD
BSRX|BAGEVADI RD
BSSL|BASI BERIASAL
BST|BASTI
BSX|BASAR
BSYA|BARKISALALYA
BSZ|BHARWA SUMERPUR
BTA|BIHTA
BTBR|BUTI BORI
BTC|BALAGHAT 
BTD|BOTAD 
BTE|BHARATPUR 
BTG|BASHARATGANJ
BTH|BETTIAH
BTI|BHATINDA 
BTIC|BHATINDA CANTT
BTJ|BISHNATHGANJ
BTJL|BHATKAL
BTK|BANKATA
BTKP|BHARAT KUP
BTP|BABATPUR
BTQ|BETNOTI
BTRA|BANTHRA
BTS|BASTA
BTSR|BHUTESHWAR
BTT|BHATNI 
BTTR|BITRAGUNTA
BTU|BARAUT
BTV|BAITARANI ROAD
BTW|BARSI TOWN
BTX|BELA TAL
BTY|BETHUADAHARI
BU|BASWA
BUA|BARADWAR
BUD|BADLAPUR
BUDI|BUNDI
BUDM|BADMAL
BUG|BAGAHA
BUH|BURHAR
BUI|BALLIA
BUP|BARIARPUR
BUPH|BABUPETH
BUQ|BARGI
BURN|BURNPUR
BUT|BAYTU
BUU|BHADANPUR
BUW|BURHWAL
BUX|BHANDAK
BV|BABHNAN
BVB|BHADBHADAGHAT
BVC|BHAVNAGAR TRMUS
BVH|BALLABGARH
BVI|BORIVALI
BVL|BIKKAVOLU
BVN|BISWAN
BVNR|BHAVANI NAGAR
BVP|BHAVANAGAR PARA
BVQ|BHILAVDI
BVRM|BHIMAVARAM 
BVRT|BHIMAVARAM TOWN
BWD|BELVANDI
BWH|BHADAURA
BWI|BILWAI
BWK|BAWANI KHERA
BWL|BAWAL
BWM|BHAWANI MANDI
BWN|BURDWAN
BWR|BARWA SAGAR
BWRA|BHARATWADA
BWSN|BIJWASAN
BWT|BANGARAPET
BXJ|BOKAJAN
BXLL|BILLI
BXM|BELRAYAN
BXN|BAYANA 
BXP|BARPATHAR
BXR|BUXAR
BXY|BORDHAL
BYL|BELHA
BYN|BANAHI
BYNR|BYNDOOR
BYPL|BAIYYAPPANAHALI
BYS|BARSALI
BYT|BHATAPARA
BZA|VIJAYAWADA 
BZLE|BAZARSAU
BZM|BHIMSEN
BZN|BAGNAN
BZO|BARSOLA
BZR|BISRA
BZU|BETUL
BZY|BASAI
CAA|CHAKIA
CAER|CHHANERA
CAF|CHANDA FORT
CAG|CHHABRA GUGOR
CAI|CHANPATIA
CAN|CANNANORE
CAP|CHATRAPUR
CAPE|KANYAKUMARI
CAR|CHUNAR
CBE|COIMBATORE 
CBF|COIMBATORE NRTH
CBK|CHACHAURA BNGJ
CBM|CUMBUM
CBN|CHIT BARAGAON
CBSA|CHAIBASA
CBU|C BABUSAMUDRAM
CC|CHAURI CHAURA
CCD|CHICHONDA
CCH|CHINCHVAD
CCL|CHANCHELAV
CCT|KAKINADA TOWN
CD|CHANDRAPUR
CDG|CHANDIGARH
CDGR|CHANDRAKONA RD
CDI|CHANDNI
CDM|CHIDAMBARAM
CDMR|CHANDAULI MJHWR
CDSL|CHANDRESAL
CE|CHHARODI
CGL|CHENGALPATTU
CGN|CHIRGAON
CGO|CHHIDGAON
CGR|CHANDAN NAGAR
CGS|CHANGSARI
CGY|CHANGANACHERI
CH|CHANDAUSI 
CHA|CHAWAPALL
CHD|CHANDIA ROAD
CHE|SRIKAKULAM ROAD
CHH|CHAUKHANDI
CHI|CHIPLUN
CHJ|CHATA
CHKB|CHAKKI BANK
CHL|CHOLA
CHN|CHHINA
CHNN|CHANNANI
CHP|CHHAPI
CHR|CHILKAHAR
CHRM|CHIRMIRI
CHSM|CHINNA SALEM
CHV|CHARVATTUR
CHZ|CHARLAPALLI
CI|CHHAPRA KACHERI
CIL|CHILBILA 
CIT|CHITALI
CJ|KANCHIPURAM
CJM|CHINNA GANJAM
C|CHHATNA
CJW|CHAJAWA
CKB|CHAUTH KA BRWRA
CKD|CHARKHI DADRI
CKDL|CHAKDAYALA
CKI|CHALAKUDI
CKNI|CHIKNI ROAD
CKP|CHAKRADHARPUR
CKR|CHIKODI ROAD
CKS|CHAKSU
CKTD|CHITRAKOT
CKU|CHAKULIA
CLD|CHALSA 
CLDY|CHANDLODIYA
CLF|CHHULHA
CLG|KAHALGAON
CLJ|COLONELGANJ
CLKA|CHILKA
CLR|CASTLE ROCK
CLT|CALICUT
CLU|CHILAKALAPUDI
CLX|CHIRALA
CMU|CHAU MAHLA
CNA|CHANDERIYA
CNB|KANPUR CENTRAL
CNC|CHINCHLI
CND|CHANDUR
CNDM|CHANDI MANDIR
CNGR|CHENGANNUR
CNH|CHAUNRAH
CNI|CHANDIL 
CNK|CHANDOK
CNO|CANACONA
CNPR|CHAINPUR
CNS|CHUCHURA
CNT|CONTAI ROAD
COA|KAKINADA PORT
COE|CHITROD
COI|CHEOKI
COM|CHOMUN SAMOD
COO|CHHOTI ODAI
COR|CHITTAURGARH
CP|CHITPUR
CPA|KANPUR ANWRGANJ
CPDR|CHHIPADOHAR
CPH|CHAMPA
CPJ|KAPTANGANJ 
CPK|CHAPARMUKH 
CPN|CHAMPANER RD 
CPP|CHIPURUPALLE
CPR|CHHAPRA
CPS|CHAND SIAU
CPT|CHANNAPATNA
CPU|CHOPAN
CRJ|CHITTARANJAN
CRK|CHARKHERA
CRKR|CHAURAKHERI
CRLM|CARMELARAM
CRN|CHAREGAON
CRP|CHANDRAPURA
CRR|KARAGOLA ROAD
CRU|CHUDAWA
CRWA|CHIRAWA
CRY|CHIRAYINKIL
CSA|CHAUSA
CSB|SHIVAJI BRIDGE
CSN|CHALISGAON 
CSTM|MUMBAI CST
CT|CHITTAPUR
CTC|CUTTACK
CTH|CHIKALTHAN
CTHR|CHITAHRA
CTJ|CHHATAINI
CTND|CHETTINAD
CTO|CHITTOR
CTR|CHATRA
CTRE|CHITTERI
CTYL|CHITYALA
CUK|CHURK
CUPJ|CUDDALORE PORT .
CUX|CHAURA
CVP|KOVILPATTI
CVR|CHORVAD ROAD
CW|CHAINWA
CWA|CHHINDWARA 
CYI|CHHAYAPURI
DAA|DATIA
DAB|DHARMABAD
DABN|DHABAN
DAE|DAHEGAON
DAKE|DAKHINESWAR
DAL|DALIGANJ
DAPD|DAPODI
DARA|DARA
DAS|DHASA 
DAV|DEVALGAON AUCHR
DAVM|DHANU VACHA PURAM HA
DBA|DABRA
DBD|DEOBAND
DBEC|DEVBALODA CHRDA
DBG|DARBHANGA 
DBR|DABHAURA
DBRG|DIBRUGARH
DBRT|DIBRUGARH TOWN
DBU|DODBALLAPUR
DBY|DIGBOI
DD|DAUND 
DDA|DURAUNDHA 
DDCE|DUNDI
DDE|DONDAICHA
DDL|DHANDARI KALAN
DDMT|DARIMETA
DDN|DEHRADUN
DDP|DAUDPUR
DDR|DADAR
DDV|DADHDEVI
DEB|DEBAGRAM
DEC|DELHI CANTT
DEE|DELHI S ROHILLA
DEG|DELANG
DEHR|DEHU ROAD
DEOR|DIYODAR
DEOS|DEORIA SADAR
DER|DADRI
DES|DESARI
DEV|DEVARAYI
DG|DINDIGUL 
DGA|DIGHWARA
DGD|DANGIDHAR
DGG|DONGARGARH
DGHA|DIGHA FLAG STN
DGI|DUNGRI
DGLE|DHULIAN GANGA
DGN|DONGARGAON
DGO|DURGAUTI
DGPP|DHENGLI PP GOAN
DGR|DURGAPUR
DGU|DIGARU
DHA|DHEENA
DHCA|DHAKA CANTONMENT
DHD|DAHOD
DHG|DHRANGDHRA
DHI|DHULE
DHN|DHANBAD 
DHNE|DHONE
DHO|DHAULPUR
DHPR|DAPPAR
DHR|DHARNAODA
DHRR|DHIRERA
DHS|DHAVALAS
DHT|DHAMARA GHAT
DHW|DHARIWAL
DI|DOMBIVIL
DIG|DUGGIRALA
DIL|DILAWARNAGAR
DING|DING
DINR|DIVINE NAGAR HALT (F
DIP|DIPORE
DISA|DISA
DIVA|DIVA
DJG|DULIAJAN
DKBJ|DAHAR KA BALAJI
DKD|DONAKONDA
DKI|DHARMKUNDI
DKJ|DORNAKAL 
DKNT|DAKANIYA TALAV
DKO|DEVAKOTTAI ROAD
DKRA|DHUANKHERI
DKT|DHULKOT
DKZ|DELHI KISHANGNJ
DL|DALADI
DLB|DAULATABAD
DLD|DALAUDA
DLI|DELHI
DLJ|DHOLA 
DLK|DALKOLHA
DLN|DILDARNAGAR 
DLO|DALGAON
DLQ|DALELNAGAR
DLR|DULLAHAPUR
DMC|DHEMAJI
DMG|DOMINGARH
DMM|DHARMAVARAM 
DMN|DHAMANGAON
DMNJ|DAMAN JODI
DMO|DAMOH
DMRT|DUMURIPUT
DMRX|DUMRI
DMV|DIMAPUR
DMW|DALMAU 
DNA|DEGANA 
DNC|DRONACHELLAM 
DND|DANDUPUR
DNJ|DAUNDAJ
DNKL|DHENKANAL
DNM|DHANMANDAL
DNN|DINA NAGAR
DNR|DANAPUR
DNRE|DHANAURI
DNRP|DUNGARPUR
DNT|DANTAN
DNW|DANGARWA
DO|DAUSA
DOA|DORAHA
DOB|DUNDLOD MKDGRH
DOD|DHODHAR
DOE|DEORI
DOL|DHOLI
DOS|DEHRI ON SONE
DPA|DURGAPURA
DPJ|DHARMAPURI
DPR|DHAMPUR
DPS|DANGOAPOSI
DPU|DIPHU
DPZ|DEVPURA
DQG|DHUPGURI
DR|DADAR
DRA|DULARIA
DRB|DEBARI
DRD|DAHANU ROAD
DRH|DHARHARA
DRHI|DAGARKHEDI
DRL|DEROL
DRLA|DAURALA
DRO|DARYAOGONJ
DRSN|DHURWASIN
DRTP|DASHARATHPUR
DRU|KADUR
DSA|DELHI SHAHDARA
DSB|SADAR BAZAR
DSJ|DELHI SAFDARG
DSK|DUSKHEDA
DSO|DESHNOK
DSS|DALSINGH SARAI
DTL|DARRITOLA
DTO|DALTONGANJ
DTRD|DIYATRA ROAD
DUA|DHAURA
DUB|DABTARA
DUBH|DUBAHA
DUD|DUDHANI
DUI|DHURI 
DUJ|DUBRAJPUR
DUR|DESUR
DURE|DUMRAON
DURG|DURG
DUSI|DUSI
DVD|DUVVADA
DVG|DAVANGERE
DVL|DEVLALI
DVM|DALBHUMGARH
DWG|DEWANGANJ
DWK|DWARKA
DWLE|DHAUNI
DWO|DOIWALA
DWP|DWARAPUDI
DWR|DHARWAR
DWX|DEWAS
DXD|DIGOD
DXG|DHARANGAON
DXK|DHANA KHERLI
DXN|DUDDHINAGAR
DY|DUMARIYA
DYD|DARYABAD
DZA|DASUYA
DZKT|DURGA CHAK TOWN
ED|ERODE 
EE|ELURU
EKC|EKCHARI
EKI|EKLAKHI
EKM|EKAMBARAKUPPAN HALT
EKMA|EKMA
EKR|EKANGARSARAI
ELM|ELIMALA
ENB|ELLENABAD
ERL|ERANIEL
ERN|ERNAKULAM TOWN
ERS|ERANAKULAM 
ET|ITARSI 
ETM|ETTUMANUR
ETP|ETTAPUR ROAD
ETW|ETAWAH
FA|FALNA
FAN|FATEHNAGAR
FAP|FAKHARPUR HALT
FAR|FARAH
FBD|FARRUKHABAD
FBG|FORBESGANJ
FD|FAIZABAD 
FDB|FARIDABAD
FDK|FARIDKOT
FDN|FARIDABAD NW TN
FGR|FATEHGARH
FGSB|FATEHGARH SAHIB
FHT|FARAH TOWN
FK|FEROK
FKB|FAKHRABAD
FKG|FURKATING 
FKM|FAKIRAGRAM 
FL|PHULERA 
FLK|FALAKATA
FM|KCG FALAKNUMA
FSG|PHURSUNGI
FSP|FATEH SINGHPURA
FTG|FURSATGANJ
FTP|FATEHPUR
FTS|FATEHPUR SIKRI
FUT|FATWA
FYZ|FAIZULLAPUR
FZD|FIROZABAD
FZR|FIROZPUR CANT
G|GONDIA 
GAA|GALAN
GAD|GEVRA ROAD
GADJ|GANDHINAGAR JPR
GAJ|GANESHGANJ
GAJB|GAJARA BAHARA
GAM|GANJAM
GAMI|GOGAMERI
GANG|GANGAGANJ
GANL|GHANAULI
GAO|GAIGAON
GAP|GURPA
GAR|GADARWARA
GATD|GAUTAMDHARA
GAYA|GAYA 
GB|GAURI BAZAR
GBA|GARHBETA
GBD|GAURIBIDANUR
GBP|GULABPURA
GBX|GOVINDPUR ROAD
GCH|GACHHIPURA
GCT|GHAZIPUR CITY
GD|GONDA 
GDA|GODHRA 
GDB|GIDDARBAHA
GDG|GADAG 
GDKP|GHUNDANKHAPA
GDL|GONDAL
GDP|GUDUPULLI
GDR|GUDUR 
GDV|GUDIVADA 
GDX|GHOKSADANGA
GDYA|GHORADONGRI
GEA|GHATERA
GED|GULEDAGUDDA RD
GEDE|GEDE
GGA|GHOGA
GGC|GANGAPUR CITY
GGJ|GOSHAINGANJ
GGN|GURGAON
GGR|GANGRAR
GGT|GHUNGHUTI
GH|GHUGHULI
GHD|GARWA ROAD
GHGL|GHAGWAL
GHH|GARHI HARSARU
GHJ|GURSAHAIGANJ
GHNA|GOHANA
GHQ|GARHWA
GHR|GIDHAUR
GHY|GUWAHATI
GID|GIDDALUR
GIMB|GANDHIDHAM BG
GIO|GORIYAN
GIR|GAINSARI 
GJD|GUJHANDI
GJH|XXXXXXXXXXXXXX
GJL|GAJRAULA 
GJUT|GANGSAR JAITU
GK|GOLA GOKARANATH
GKB|GHATAKA VARANA
GKC|GORAKHPUR CANT
GKH|GUSKARA
GKK|GOKAK ROAD
GKP|GORAKHPUR
GLA|GARLA
GLG|GULABHGANJ
GLGT|GOLAGHAT
GLH|GULAOTHI
GLP|GOLLAPROLU
GLPT|GOAL PARA TOWN
GMAN|GUMANI
GMD|GURAMKHEDI
GMDN|GIRIMAIDAN
GMG|GUMGAON
GMH|GAMHARIA
GMIA|GUMIA
GMO|GOMOH 
GMR|GAHMAR
GMS|GARHMUKTESAR
GNA|GONEANA
GNC|GANDHINAGAR CAP
GND|GOVINDGARH MALK
GNG|GAURIGANJ
GNGD|GANGADHARPUR
GNH|GANGAKHER
GNJ|GUNJI
GNP|GHANPUR
GNS|GHONSOR
GNT|GUNTUR 
GNU|GANAUR
GNW|GANGIWARA
GO|GHOTI
GOA|GOHAD ROAD
GOC|PONMLAI GLD RCK
GOGH|GOSSAIGAON HAT
GOH|GAROT
GOK|GOKARNA ROAD (HALT)
GOL|GOILKERA
GOP|GOP JAM
GOTN|GOTAN
GOY|GOVINDPURI
GP|RAJ GANGPUR
GPB|GHATPRABHA
GPC|GHATPINDRAI
GPD|GUMMIDIPUNDI
GPH|GARPOS
GPR|GHORPURI
GQL|GURLA
GR|GULBARGA
GRA|GHARAUNDA
GRF|GAMBHIRI ROAD
GRKN|GORAKHNATH
GRL|GORAUL
GRMR|GARHI MANIKPUR
GRO|GURRA
GRRU|GURARU
GRWD|GHORAWADI
GRY|GORAYA
GSD|GHOSUNDA
GSP|GURDASPUR
GSPR|GOSALPUR
GTJT|GETOR JAGATPURA
GTK|GHUTKU
GTL|GUNTAKAL 
GTM|GHATAMPUR
GTNR|GOMATI NAGAR
GTRA|GOTRA HALT
GTS|GHATSILA
GUD|GALUDIH
GUH|GULDHAR
GUNA|GUNA
GUR|GANAGAPUR ROAD
GUV|GURUVAYUR
GVB|GUNERU BAMORI
GVD|GHOLVAD
GVG|GOVINDGARH
GVI|GARIVIDI
GVL|GUDLAVALLERU
GVN|GODAVARI
GW|GIRWAR
GWA|GANJ DUNDWARA
GWD|GADWAL
GWL|GWALIOR
GWV|GOWDAVALLI
GY|GOOTY
GYM|GUDIYATTAM
GYN|GYANPUR ROAD
GZB|GHAZIABAD
GZH|GULZARBAGH
GZN|N GHAZIABAD
HA|HARGAON
HAD|HARIPAD
HAN|HINDAUN CITY
HAPA|HAPA
HAR|HAMIRPUR ROAD
HAS|HASSAN
HATI|HATI
HBD|HOSHANGABAD
HBG|HOWBADH JABLPUR
HBJ|HABIBGANJ
HCNR|HARI CHANDANPUR
HCP|HARCHANDPUR
HCR|HARISCHANDRPUR
HD|HARDA
HDA|HIRNODA
HDB|HALDIBARI
HDE|HARDAS BIGHA
HDK|HANDIA KHAS
HDL|HODAL
HDN|HAIDARNAGAR
HDP|HADAPSAR
HDU|HARDUA
HDW|HALDWANI
HEM|HIMAYATNAGAR
HG|HOTGI
HGH|HAIDERGARH
HGT|HINGANGHAT
HIL|HILSA
HIND|HIND
HIR|HARINAGAR
HJI|HOJAI
HJP|HAJIPUR 
HKG|HIRAKUD
HKL|HARKIA KHAL
HLAR|HOLE ALUR
HLDD|HALDI ROAD
HLDR|HALDAUR
HLN|HOLE NARSIPUR
HLZ|HALDIA
HMG|HAMIRGARH
HMH|HANUMANGARH 
HMRR|HAMARAPUR
HMT|HIMMATNAGAR
HN|HATHBANDH
HNA|HONNAVAR
HNL|HINGOLI DECCAN
HNM|HINAUTARAMBAN
HNS|HANSI
HOJ|HAMITONGANJ
HP|HARIPUR
HPLE|HATPURAINI
HPO|HASANPUR ROAD
HPP|HARPALPUR
HPR|HIRAPUR
HPT|HOSPET 
HPU|HAPUR
HRB|HARRI
HRG|HIRDAGARH
HRI|HARDOI
HRNR|HIRA NAGAR
HRPG|HARPALGANJ
HRR|HARIHAR
HRS|HATHRAS 
HRT|HARNAUT
HRV|HARRAD
HRW|HARRAWALA
HSA|HASIMARA
HSI|HARSAULI
HSK|HARISHANKER RD
HSL|HISVAHAL
HSP|XXXXXXXXXXXXXXX
HSR|HISAR
HSRA|HOSUR
HSX|HOSHIARPUR
HTC|HATHRAS CITY
HTE|HATIA
HTK|HATKALANGDA
HTN|HATNA PUR
HTZ|HATHIDAH 
HUP|HINDUPUR
HVD|HALVAD
HVR|HAVERI
HW|HARIDWAR 
HWH|HOWRAH 
HX|CUDDAPAH
HYB|HYDERABAD DECAN
HYT|HAIAGHAT
HZD|HAZARIBAGH RD
HZR|HAFIZPUR
IAA|INDARA 
ICL|ICHAULI
IDG|INDARGARH
IDGJ|IRADATGANJ
IDH|IDGAH AGRA 
IDJ|IDALHOND
IDR|INDI ROAD
IGP|IGATPURI
IJ|ITAUNJA
IJK|IRINJALAKUDA
IKK|IKKAR
IKR|IKLEHRA
IMGE|ISMAILPUR
IMR|IBRAHIMPUR
INDB|INDORE  BG
IPL|IDAPLLI
IPM|ICHCHPURAM
IPR|ISLAMPUR
ISA|ISARDA
ISH|ISARWARA
ISM|ISMAILA HARYANA
ITA|ITOLA
ITR|ITWARI
IZN|IZZATNAGAR
J|JALNA
JAA|JHALIDA
JAB|YAMUNA BDG AGRA
JAIS|JAIS
JAJ|JHAJHA
JAL|JAWALI
JAM|JAMNAGAR
JAO|JAORA
JAT|JAMMU TAWI
JBN|JOGBANI
JBP|JABALPUR
JCL|JADCHERLA
JER|JALESWAR
JEUR|JEUR
JGJ|JAGESHARGANJ
JGM|JHARGRAM
JGN|JAGRAON
JGR|JASWANTNAGAR
JHD|JEHANABAD
JHL|JAKHAL 
JHN|JAKHIM
JHS|JHANSI 
JHT|JUNEHTA
JHW|JHALAWAR ROAD
JID|JAGI ROAD
JIND|JIND 
JITE|JITE
JJG|JIAGANJ
JJK|JHINJHAK
JJKR|JAJPUR K ROAD
JJR|JEJURI
JKA|JAKHVADA
JKE|JUKEHI
JKM|JANKAMPET 
JKN|JAKHANIAN
JKNI|JHARKHANDI
JKPR|JAKHAPURA
JKR|JAULKHERA
JKT|JEKOT
JL|JALGAON 
JLD|JARWAL ROAD
JLL|JALALGANJ
JLN|JAKHALAUN
JLR|JETALSAR 
JLS|JALESAR ROAD
JLW|JHALWARA
JM|JALAMB 
JMB|JAMBUSAR .
JMBC|JAMBUSAR CITY
JMD|JAMDHA
JMK|JAMUNAMUKH
JMKL|JAMUNIA KALAN
JMKT|JAMIKUNTA
JMP|JAMALPUR 
JMT|JAMTARA
JMU|JAMUI
JMV|JAMBARA
A|JULANA
D|JUNAGADH JN
H|JANGHAI JN
L|JANDIALA
O|JUNNOR DEO
R|JANAKPUR ROAD
TR|JINTI ROAD
U|JAUNPUR JN
JOA|JANWAL
JOB|ASALPUR JOBNER
JOBA|JOBA
JOC|JOYCHANDI PAHAR
JOP|JAUNPUR CITY
JP|JAIPUR
JPD|JALALPUR DHAI
JPE|JALPAIGURI ROAD
JPG|JALPAIGURI
JPH|JHANTIPAHARI
JPL|JAPLA
JRA|JARAIKELA
JRC|JALANDHAR CANT
JRK|JERUWA KHERA
JRLE|JANGIPUR ROAD
JRMG|JAIRAMNAGAR
JRR|JUGAUR
JRU|CHIKJAJUR 
JSG|JHARSUGUDA 
JSM|JAISALMER
JSME|JASIDIH 
JSP|JAYASINGPUR
JSR|JASRA
JSV|JARANDESHWAR
JTB|JAGATBELA
JTI|JAITHARI
JTJ|JOLARPETTAI
JTTN|JORHAT TOWN
JTW|JAITWAR
JU|JODHPUR 
JUC|JALANDHAR CITY
JUD|JAGADHRI
JUDW|JAGADHRI WSHOP
JVN|JORAWARNAGAR 
JWB|JAWAI BANDH
JWL|JAJIWAL
JWO|JAWAD ROAD
JWP|JWALAPUR
JYG|JAYNAGAR
JYM|JAI SAMAND ROAD
KAD|KHANDALA
KAH|KALHAR
KAJ|KALIYANGANJ
KAL|KALLAI
KAMG|KAMAKHYAGURI
KAMP|KAMALPUR
KAN|KHANA 
KAOT|KAOTHA
KAP|KALIANPUR
KAPG|KALUPARA GHAT
KAR|KARNA
KARD|KAMAN ROAD
KART|KIRATPUR SAHIB
KASR|KANAS ROAD
KASU|KASU
KAT|KHATAULI
KATI|KANTHI P H
KATL|KATOL
KAVI|KAVI
KAWR|KARWAR
KAYR|KAYAR
KBE|KUREBHAR
KBI|KAMBRGANVI
KBJ|KANTABANJI
KBL|KOPPAL
KBM|KOTABOMMALI
KBN|KARBIGWAN
KBPR|KABAKA PUTTUR
KBRV|KANJARI BORIYAV
KBSN|KASBE-SUKENE
KCA|KUCHMAN
KCC|KRISHNA CANAL
KCD|KURICHEDU
KCF|KALCHINI
KCG|KACHEGUDA
KCJ|KASIMPUR
KCNR|KACHNARA ROAD
KCO|KACHHIA BRIDGE
KCVL|KOCHUVELI
KDG|KEDGAON
KDHA|KARCHHA
KDJR|KENDUJHAR
KDK|KOHDAD
KDM|KESAMUDRAM
KDNL|KADAYNALLUR
KDP|KONDAPURAM
KDPR|KUMEDPUR
KDRP|KANDARPUR HALT
KDU|KADAMBUR
KDV|KHADAVLI
KE|KHARDI
KEA|KATRA
KEG|KARENGI
KEH|KAPSETI
KEI|KASHI
KEK|KARKHELI
KEM|KEM
KEMR|KEMRI HALT
KEPR|KOIRIPUR
KER|KIRIHRAPUR
KEX|KHEKRA
KFA|KOPARIA
KFH|KATPHAL
KFY|KARAPGAON
KGA|KHAGA
KGB|KARGI ROAD
KGG|KHAGARIA
KGI|KENGERI
KGL|KUPGAL
KGLE|KHAGRAGHAT ROAD
KGM|KATHGODAM
KGP|KHARAGPUR 
KGQ|KASARAGOD
KGS|KHONGSARA
KGX|KANGINHAL
KH|KAHILIYA
KHA|KHAIGAON
KHBJ|KHANNA BANJARI
KHBV|KHARBAO
KHD|KHODIYAR
KHED|KHED
KHH|KICHHA
KHM|KUSMHI
KHNM|KUNDA HARNAMGNJ
KHRJ|KUMBHRAJ
KHRK|KHARAK
KHS|KHARSIA
KHT|SRI KALAHASTI
KHU|KHURHAND
KI|KONDAPALLI
KID|KHAIRAR 
KIKA|KURWAI KETHORA
KIM|KIM
KIN|KAPASAN
KIP|KHALILPUR
KIR|KATIHAR 
KIS|KAPILAS ROAD
KIT|KHALLIKOT
KITN|KHIRI TOWN
KIUL|KIUL 
KIW|KANWALPURA
KIZ|KANSUDHI
KJ|KAJGAON
KJA|KHAJURHAT
KJG|KARAJGI
KJH|KAJRA
KJI|KHAJAULI
KJL|KHUMGAON BURTI
KJM|KRISHNARAJAPURM
K|KANNAUJ
KJT|KARJAT
KJY|KHURJA CITY
KJZ|KARONJI
KK|KHADKI
KKAH|KANKAHA
KKB|KARAK BEL
KKDE|KURUKSHETRA 
KKDI|KARAIKKUDI 
KKGM|KAKRI GUMA
KKHT|KAKARGHATTI
KKI|KARKELI
KKJ|KAKORI
KKLR|KAIKOLUR
KKM|KAMALAPURAM
KKN|KHIRKIYA
KKP|KOT KAPURA
KKPM|KALLAKKUDI PLGH
KKTA|KOLLIKHUTAHA
KKU|KANAKPURA
KKW|KANKAVALI
KL|KHERIL
KLAR|KULPAHAR
KLB|KIRAOLI
KLBA|KALAMBHA
KLD|KHALILABAD
KLG|KALUNGA
KLH|KHEMLI
KLJ|KAMALGANJ
KLK|KALKA
KLL|KALOL
KLMG|KALAMBOLI GOODS
KLNK|KALANAUR KALAN
KLP|KOTALPUKUR
KLPM|KAILASAPURAM
KLRE|KHALARI
KLRS|KOLARAS
KLT|KULITALAI
KLTR|KALMITAR
KLU|KALLURU
KLV|KELVA ROAD
KLYT|KOLAYAT
KMA|KAIMA
KMBL|KHAMBHALIYA
KMC|KAMAREDDI
KMD|KODUMUDI
KMDR|KARIMUDDIN PUR
KMJ|KAIMGANJ
KMKD|KHAMKHED
KML|KAMTAUL
KMME|KUMARDUBI
KMNC|KUCHAMAN CITY
KMNR|KAMALNAGAR
KMQ|KUMBLA
KMS|KARAMNASA
KMST|KAMSHET
KMT|KHAMMAM
KMU|KUMBAKONAM
KMV|KARMAD
KMZ|KATNI MURWARA
KN|KADALUNDI
KND|KANDRA
KNDP|KHANDIP
KNE|KISHANGANJ
KNGM|KANGAM
KNGN|KANHEGAON
KNJ|KRISHNGR CTY 
KNL|KALANWALI
KNLS|KANALAS 
KNN|KHANNA
KNP|KHANAPUR
KNPL|KANDANUR P VAYA
KNPR|KENDRAPARA ROAD
KNT|KANTH
KNVT|KINWAT
KNW|KHANDWA
KO|KOSGI
KOAA|KOLKATA
KODI|KODI
KOHL|KOHLI
KOI|KHODRI
KOJ|KOKRAJHAR
KOLR|KOLNUR
KON|KUDAL NAGAR
KOO|KHUSROPUR
KOP|KOLHAPUR
KOPR|KOPAR ROAD
KORA|KORA
KOTA|KOTA 
KOU|KODURU
KOV|KIRLOSKARVADI
KP|KAMPTEE
KPD|KATPADI 
KPG|KOPARGAON
KPGM|KARPOORIGRAM
KPI|KALPI
KPKI|QASIMPUR KHERI
KPN|KUPPAM
KPNA|KAPAN
KPP|KALAPIPAL
KPQ|KANNAPURAM
KPRD|KALYANPUR ROAD
KPTN|KESHORAI PATAN
KPV|KASHIPUR
KPY|KARUNAGAPALLI
KPZ|KAPREN
KQK|KOTIKULAM
KQL|KANDHLA
KQN|KODAIKANAL ROAD
KQR|KODERMA
KQT|KURGUNTA
KQU|KAMARKUNDU
KRAR|KHARIAR ROAD
KRBA|KORBA
KRBP|KHUDIRAM B PUSA
KRD|KARAD
KRE|KARTARPUR
KRG|KOREGAON
KRH|KHAIRTHAL
KRI|KHAPTI
KRIH|KORAI HALT
KRJ|KHURJA 
KRKP|KYARKOP
KRLI|KURALI
KRLR|KARAILA ROAD 
KRLS|KURLAS
KRMI|KARMALI
KRND|KHORASON ROAD
KRNR|KRISHANRAJANAGA
KRNT|KURNOOL TOWN
KRO|KURAWAN
KRPU|KORAPUT
KRR|KARUR
KRS|KARISATH
KRSA|KHARSALIYA
KRSL|KRISHNASHILLA
KS|KHETA SARAI
KSB|KOSAMBA 
KSC|KASHI CHAK
KSD|KESHOD
KSF|KHALISPUR
KSG|KISHANGARH
KSH|KALI SINDH
KSJ|KASGANJ
KSJF|KASGANJ
KSM|KAMASAMUDRAM
KSN|KRISHNA
KSNG|KESINGA
KSRA|KASARA
KSTA|KASTHA
KSTH|KASHTI
KSV|KOSI KALAN
KSW|KHERI SALWA
KSWD|KASAR WADI
KSX|KOTSHILA
KT|KUMTA
KTA|KUSHTALA
KTDD|KATAIYA DANDI
KTE|KATNI
KTGA|KEUTIGUA
KTH|KATRASGARH
KTHA|KHUTAHA
KTHD|KOTHARI ROAD
KTHU|KATHUA
KTKD|KATANGI KHURD
KTKL|KOTLI KALAN
KTM|KUTRALAM
KTMA|KOTMA
KTO|KATORA
KTP|KATEPURNA
KTQ|KUDRA
KTRH|KATAREAH
KTRR|KATHARA ROAD
KTSH|KOTMI SONAN HLT
KTU|KUTTIPPURAM
KTV|KOTTAVALASA
KTW|KOTDWARA
KTYM|KOTTAYAM
KTZ|KHUTWANSA
KUA|KULHARIA
KUD|KUDACHI
KUDA|KUNDAPURA
KUDL|KUDAL
KUE|KURSELA
KUF|KAURHA
KUH|KHACHROD
KUM|KURAM
KUMB|KUMARBAGH
KUN|KARNAL
KUPR|KHURDPUR
KUR|KHURDA ROAD 
KURJ|KHAJURAHO
KUU|KUHURI
KUX|KHIRSADOH 
KVG|KUNEANGANJ
KVM|KAVUTARAM
KVR|KOVVUR
KVU|KADAKAVUR
KVZ|KAVALI
KW|KHERVADI
KWAE|KATWA
KWE|KHURIAL
KWM|KAMPUR
KWO|KARAUTA
KWR|KOELWAR
KWV|KURDUVADI
KXH|KAPURTHALA
KXM|KITHAM
KXN|KANSHBAHAL
KY|KARELI
KYE|KHURAI
KYF|KAJRAT NAWADIH
KYJ|KAYANKULAM
KYM|KADIYAN
KYN|KALYAN 
KYOP|KOTTAPALLI
KYQ|KAMAKHYA
KYT|KAILAHAT
KYX|KARHIYA BHADELI
KZA|KHADA
KZB|KURUMBUR
KZE|KANHANGAD
KZJ|KAZIPET 
KZK|KAZHAKUTTAM
KZT|KULITTHURAI
KZTW|KULITTURAI WEST
KZY|KAYALPATTINAM
LAN|LOTANA
LAR|LALITPUR
LAUL|LAUL
LAV|LABHA
LBA|LAMBHUA
LBG|LIMBGAON
LBN|LABAN
LC|LUCKNOW CITY
LD|LONDA 
LDA|LIDHORA KHURD
LDH|LUDHIANA 
LEDO|LEDO
LGCE|LAGARGAWAN
LGH|LALGARH 
LGL|LALGOLA
LGO|LALGOPALGANJ
LHA|LEHRA GAGA
LHLL|LAHLI
LHN|LACHYAN
LHU|LOHARU
LJR|LANJIGARH ROAD
LKA|LANKA
LKE|LAKHERI
LKKA|LAL KUAN
LKMR|LAKSHMIPUR ROAD
LKN|LAKHMINIA
LKO|LUCKNOW
LKR|LUCKEESARAI 
LKS|LUNKARANSAR
LKU|LAL KUAN
LKY|LAKHMAPUR
LKZ|LAKADIYA
LLGM|LELIGUMMA
LLI|LALGUDI
LLJ|LALGANJ
LM|LIMBDI
LMG|LUMDING 
LMK|LIMKHEDA
LMN|LACHHMANPUR
LMNR|LAKSHMIBAI NGR
LMP|LAKHIMPUR
LMT|ALMATTI
LNK|LOHIAN KHAS 
LNL|LONAVALA
LNN|LONAND
LNR|LUNI RICHHA
LOA|LORHA
LOG|LOHGARA
LONI|LONI
LPI|LINGAMPALLI
LPJ|LALPUR JAM
LRD|LAR ROAD
LRJ|LAKSAR 
LRU|LALPUR UMRI
LS|LASALGAON
LSI|LAHERIA SARAI
LSR|LASUR
LSX|LOISINGHA
LT|LAHAVIT
LTA|LAMTA
LTHR|LATEHAR
LTR|LAKHTAR
LTRR|LATUR ROAD
LTT|LOKMANYATILAK
LUNI|LUNI 
LUR|LATUR
LUSA|LUSA
LWR|ALNAVAR 
LXA|LAKSWA
MA|MADHA
MAAR|MALHAR
MABA|MANDI BAMORA
MABD|MAHBUBABAD
MAD|MADDUR
MAG|MANGALAGIRI
MAGH|MANIKGARH
MAHE|MAHE
MAI|MEHSI
MAKM|MARARIKULAM
MALB|MALIYA MIYANA .
MALK|MALKAPUR ROAD
MALM|MANTHRALAYAM RD
MAM|MANGAL MAHUDI
MAN|MANINAGAR
MANA|MANA
MANI|MANI NAGAR
MAO|MADGAON
MAP|MORAPPUR
MAQ|MANGALORE
MAR|MULANUR
MAS|CHENNAI CENTRAL
MAU|MAU 
MAUR|MAUR
MAY|MARIAHU
MB|MORADABAD
MBA|MAHOBA
MBB|MURSHIDABAD
MBI|MADHUBANI
MBM|MAMBALAM
MBNR|MAHBUBNAGAR
MBP|MOHIBULLAPUR
MBS|MADHOSINGH
MBY|MANDI DABWALI
MCA|MECHEDA
MCI|MANCHERAL
MCLE|MANCHILI
MCN|MUKUNDARAYAPURM
MCQ|MIRCHADHORI
MCS|MANCHESWAR
MD|MADAR
MDDP|MANDI DIP
MDE|MAKHDUMPUR GAYA
MDF|MURADI
MDGR|MANENDRAGARH
MDJ|MUHAMMADGANJ
MDKD|MADHUKUNDA
MDL|MANDAL
MDLM|MUNDALARAM
MDN|MIDNAPORE
MDNR|MODINAGAR
MDP|MADHUPUR 
MDPB|MADHOPUR PUNJAB
MDR|MADHIRA
MDRR|MADHAVNAGAR ROAD
MDS|MANDASOR
MDT|MADARIHAT
MDU|MADURAI 
MDVK|MAHADEOKHEDI
MDVL|MANDAVALLI
MDVR|MADHAVNAGAR
MDW|MARWAR MUNDWA
MDXR|MUDARIA
MED|MEDCHAL
MEH|MELALATHUR
MEJ|MANIYACHCHI 
MEM|MAU AIMMA
MEP|MAHIDPUR ROAD
MER|METPANJRA
MET|MALERKOTLA
MEX|MUKERIAN
MFKA|MUSAFIR KHANA
MFL|MISRAULI
MFP|MUZAFFARPUR 
MFQ|MAHROI
MG|MODELGRAM
MGAE|MORGRAM
MGC|MUGAT
MGD|MUGAD
MGF|MANDAGERE
MGG|MANGLIYA GAON
MGLP|MANGOLPURI
MGME|MCCLUSKIEGANJ
MGN|MEGHNAGAR
MGS|MUGHAL SARAI 
MHA|MARAHRA
MHAD|MOHADI PRGN LNG
MHD|MHMDVD KHEDA RD
MHH|MAGHAR
MHJ|MAHAJAN
MHQ|MAHUDA
MHRG|MAHENDRAGARH
MHT|MANJHI
MHV|MAHUVA 
MID|MADHI
MIH|MIHRAWAN
MIL|MILAK
MIN|MIHINPURWA
MINA|MYANA
MIQ|MIRHAKUR
MJ|MARWAR 
MJA|MEJA ROAD
MJF|MALKAJGIRI
MJG|MAJHAGAWAN
MJHR|MAJHIARI
MJL|MAJHOWALIA
M|MAKUM JN
MJRI|MAJRI 
MJS|MANJESHWAR
MK|MIRANPUR KATRA
MKA|MOKAMEH 
MKB|MANKATHA
MKC|MAKSI
MKD|MARKUNDI
MKDI|MAKUDI
MKH|MALAKHERA
MKI|MOTIHARI
MKN|MAKRANA 
MKO|MARKONA
MKP|MANIKPUR 
MKPT|MALIKPETH
MKR|MADDIKERA
MKRN|MAKRONIA
MKU|MALKAPUR
MKX|MORAK
ML|MALHOUR
MLAR|MALANPUR
MLB|MODNIMB
MLD|MALIHABAD
MLDT|MALDA TOWN
MLG|MALHARGARH
MLGH|MANDAL GARH
MLHA|MALIYA HATINA
MLJ|MOHANLALGANJ
MLM|MALTHAN
MLMR|MELMARUVATTUR
MLN|MAILANI
MLO|MALUR
MLP|MALLAPUR
MLPR|MALIPUR
MLR|MALKHED
MLV|MALLARPUR
MLX|MULLANPUR
MLY|MAULA ALI
MLZ|MALARNA
MMA|MUHAMMADABAD
MMB|MAHMUDABAD AVDH
MME|MUL MARORA
MMH|MAHADANAPURAM
MMK|MADURANTAKAM
MML|MADAN MAHAL
MMM|MANDAPAM
MMR|MANMAD 
MMS|MANDASA ROAD
MMY|MARWAR MATHANYA
MMZ|MANDAMARI
MNAE|MANKAR
MND|MUNDERWA
MNDA|MANDURA
MNDH|MANDIR HASAUD
MNDR|MANDI DHANAURA
MNE|MANSI 
MNF|MANDA ROAD
MNGD|MUNIGUDA
MNI|MANGAON
MNJ|MANOHARGANJ
MNL|MINCHNAL
MNM|MANAMADURAI 
MNO|MEHNAR ROAD
MNP|MANANPUR
MNQ|MAINPURI
MNSR|MANAKSAR
MNTT|MULANTURUTTI
MNV|MUNGAOLI
MO|MOHOL
MOF|MONDH
MOG|MOHIUDDINNAGAR
MOGA|MOGA
MOI|MORI BERA
MOL|MULI ROAD
MOM|MAMAN
MOO|MUDDANURU
MOP|MOHITNAGAR
MOR|MOR
MOT|MALOUT
MOTC|MOTICHUR
MOTH|MOTH
MOU|MANOHARPUR
MOZ|MUZAFFARNAGAR
MPA|MANAPARAI
MPI|MELPATTI
MPLM|MARTHIPALAYAM
MPU|MEDAPADU
MPY|MURARPUR
MQL|MIRKHAL
MQO|MUNROTURUTTU
MQR|MALKHAID ROAD
MQS|MALSIAN SHAHKHT
MQU|MURUKKAMPUZHA
MQX|MERALGRAM
MRA|MORENA
MRB|MUNIRABAD
MRBL|MURIBAHAL
MRDW|MURDESHWAR
MRE|MANAURI
MRG|MARGHERITA
MRGA|MIRYALAGUDA
MRHT|MORANHAT
MRJ|MIRAJ 
MRK|MARKAPUR ROAD
MRL|MAROLI
MRN|MORWANI
MRND|MORINDA
MRPR|MAU RANIPUR
MRR|MURARAI
MRT|MATHURA CANT
MRTL|MIRTHAL
MS|CHENNAI EGMORE
MSDH|MASNADIH
MSDN|MASUDAN
MSH|MAHESANA 
MSK|MAHES KHUNT
MSMD|MAHASAMUND
MSR|MASUR
MST|MASIT
MSW|MASKANWA
MSZ|MANSA
MTA|MATHELA
MTC|MEERUT CITY
MTD|MERTA ROAD 
MTHP|MITHAPUR
MTJ|MATHURA 
MTM|MACHELIPATNAM
MTP|METUPALAIYAM
MTPC|MOTIPURA CHAUKI
MTPR|RAIMAHTPUR
MTR|MOTIPUR
MTT|MUTUPET
MTU|MATMARI
MTY|MULTAI
MUD|MURADNAGAR
MUE|MUDKHED
MUGA|MAHUGARA
MULK|MULKI
MUO|MASANGAON
MUR|MANKAPUR 
MURD|MANDAWAR M RD
MURI|MURI
MUT|MEERUT CANT
MUV|MANDUADIH
MUW|MATHURAPUR
MV|MAYILADUTURAI J
MVD|MULVAD
MVE|MUNDHEWADI
MVI|MORBI
MVJ|MAVLI 
MVL|MALAVLI
MVLK|MAVELIKARA
MVN|MILAVITTAN
MVO|MANWATH ROAD
MW|MAIRWA
MWA|MANDWA
MWD|MHASAVAD
MWF|MAGARDAHA
MWH|MALWAN
MWJ|MARWASGRAM
MWK|MORDAD TANDA
MWM|MALLESWARAM
MWT|MARWAR LOHWAT
MWX|MALLANWALA KHAS
MXH|MAKHU
MXK|MANDRAK
MXL|MOKHOLI
MXN|MARIANI 
MXT|MALAKPET KCG
MYA|MANDYA
MYG|MIYAGAM KARJAN
MYGL|MIYAGAM K  NG
MYJ|MAHEJI
MYR|MAIHAR
MYS|MYSORE 
MYY|MAYYANAD
MZC|MIRZA CHEUKI
MZH|MAUHARI
MZL|MIRZAPALI
MZM|MUZZAMPUR NRYN
MZP|MIRZAPUR
MZR|MURTAJAPUR
MZS|MURKEONGSELEK
NAB|NAGBHIR 
NAC|NAWA CITY
NAD|NAGDA 
NAG|NAGARGALI
NAL|NAL HALT
NAM|NAMRUP
NANA|NANA
NANR|NARANPUR
NAS|NASRALA
NAT|NATHNAGAR
NAW|NAWANDGI
NAZJ|NAZIRGANJ
NB|NIMBHORA
NBA|NABHA
NBD|NAJIBABAD 
NBG|NABENAGAR ROAD
NBH|NIMBAHERA
NBI|NADBAI
NBL|NIMBAL
NBQ|NEW BONGAIGAON
NBR|NAMBURU
NCB|NEW COOCH BEHAR
NCJ|NAGARCOIL 
NCR|NAGORE
ND|NADIAD 
NDAE|NABADWIP DHAM
NDB|NANDURBAR
NDD|NIDADAVOLU 
NDE|NANDRE
NDH|NINDHAR BENAR
NDJ|NANDGANJ
NDKD|NADIKODE
NDL|NANDYAL
NDLS|NEW DELHI
NDO|NIDUBROLU
NDU|NADAUJ
NDW|NADWAN
NED|NANDED
NEO|NEORA
NEW|NIVARI
NFK|NEW FARAKKA 
NG|NAGARI
NGD|NAGARDEVLA
NGE|NAGAR
NGG|NAGINA
NGI|NAGARI
NGLT|NAGLATULA
NGN|NANDGAON
NGNT|NEW GUNTUR
NGO|NAGAUR
NGP|NAGPUR
NGR|ANNIGERI
NGT|NAGAPPATTINAM
NGTN|NAGOTHANE
NGZ|S K NAGJIHARI
NH|NAIHATI 
NHH|NIHALGARH
NHK|NAHARKATIYA
NHN|NIGOHAN
NHR|NOHAR
NHT|NALHATI 
NI|NAYDONGRI
NIA|NAILA
NIDI|NIDI
NILE|NIMITITA
NIQ|NIGAURA
NIR|NAINPUR 
NIRA|NIRA
NIU|NABIPUR
NJP|NEW JALPAIGURI
NJT|NAGER COIL TOWN
NK|NASIK ROAD
NKB|NAGRAKOTA
NKD|NEKONDA
NKE|NARKATIAGANJ 
NKH|NATHUKHERI
NKM|NAMKON
NKP|NIRAKARPUR
NKRA|NOKHRA
NLD|NALANDA
NLDA|NALGONDA
NLDM|NANGAL DAM
NLE|NILESHWAR
NLI|NAMLI
NLKR|NILOKHERI
NLP|NORTH LAKHIMPUR
NLR|NELLORE
NLV|NALBARI
NMD|NOMODA
NMGY|NUMOLIGARH
NMH|NIMACH
NMK|NIM KA THANA
NMP|NIMPURA
NMX|NEW MAYNAGURI
NMZ|NEW MAL 
NN|NANDURA
NNA|NAUGACHIA
NNE|NONERA
NNGL|NAYANANGAL
NNKR|NANAKSAR
NNL|NARNAUL
NNN|NANGUNERI
NNO|NANGLOI
NNP|NANPARA 
NNR|NARAYANPUR
NNW|NRYNPUR TATWAR
NOI|NARIAOLI
NOK|NOKHA
NOLI|NOLI
NOMD|NOAMUNDI
NOQ|NEW AILPURDAUR
NPD|NAWAPARA ROAD
NPNR|NEPANAGAR
NPRD|NAGPUR ROAD
NPW|NIPANI VADGAON
NR|NIPHAD
NRDP|NAGIREDDIPALLI
NRE|NANDALUR
NRG|NERGUNDI
NRGR|NARANJIPUR
NRI|NARAINA
NRKR|NARKHER
NRL|NERAL
NRLR|NORIA ROAD
NRM|NURMAHAL
NRO|NAKODAR 
NRP|NARSIPATNAM RD
NRPA|NARAYNPUR ANANT
NRPD|NARAYANPET ROAD
NRR|NAGARUR
NRS|NAGARIA SADAT
NRT|NARASARAOPET
NRW|NARWANA 
NRZB|NOWROZABAD
NS|NARASAPUR
NSD|NASIRABAD
NSL|NAGARSOL
NSU|NISUI
NTSK|NEW TINSUKIA
NTV|NAUTANWA
NU|NARSINGHPUR
NUA|NUA
NUD|NAVAGADH
NUH|NAUGARH
NUJ|NUJELLA
NUQ|NAGAR UNTARI
NUR|NARELA
NVRD|NAVADE ROAD
NVS|NAVSARI
NVT|NAVIPET
NVU|NAVALUR
NW|NALWAR
NWA|NAGARWARA
NWB|NIWAS ROAD
NWD|NAWADAH
NWH|NAWALGARH
NWP|NAUPADA 
NWR|NIWAR
NWU|NAVAPUR
NXN|NUAGAON
NYN|NAINI
NYO|NAYAGAON
NYP|NAYADUPETA
NYY|NEYYATTINKARA
NZB|NIZAMABAD
NZD|NUZVID
NZM|HAZRAT NIZAMUDDIN
NZT|NAZARETH
OBR|OBRA DAM
OBVP|OBULAVARIPALLI
ODB|OODLABARI
ODG|OBAIDULLA GANJ
ODHA|ODHA
ODM|ONDAGRAM
OEA|ODELA
OGL|ONGOLE
OKA|OKHLA
OKHA|OKHA
OML|OMALUR
ON|UNNAO 
OPL|UPPAL
ORAI|ORAI
ORDI|ORDI
ORGA|ORGA
ORR|ORR
OSN|OSIYAN
OTP|OTTAPPALAM
OYR|WARIA
PAA|PATAS
PAD|PARDI
PAI|PABAI
PAK|PAKALA 
PAL|PALASNER
PAN|PANAGARH
PANP|PANDAVAPURA
PAO|PANOLI
PAP|PITHAPURAM
PAR|PANDHURNA
PARD|PATHRAD
PASA|PARASHSHALA
PAU|PURNA 
PAV|PEDANA
PAW|PANDABESWAR
PAY|PAYYANUR
PAZ|PAYANGADI
PB|PUNTAMBA
PBE|PHILIBHIT
PBH|PARTAPGARH 
PBKS|PMBAKVL SHANDY
PBL|PATHSALA
PBM|PAMBAN 
PBN|PARBHANI 
PBP|PEMBARTI
PBQ|PATHARDIH BAZAR
PBR|PORBANDAR
PBW|PANTNAGAR
PC|PACHORA 
PCH|PACHHAPUR
PCLI|PALACHAURI
PCN|PANCH PIPILA
PCV|PALAKKODU
PDD|PADUBIDRI
PDE|PINDRAI
PDG|PARADGAON
PDGN|PADHEGAON
PDH|PADADHARI
PDI|PALASHARI
PDKN|PEDAKAKANI HALT
PDKT|PUDUKKOTTAI
PDL|PENDEKALLU
PDPL|PEDDAPALLI
PDR|PAYAGPUR
PDRD|PINDRA ROAD
PDU|PONDURU
PDW|PANDAUL
PDY|PONDICHERRY
PDZ|PILIODA
PEH|PATHARDIH 
PEN|PEN
PEP|PHEPHNA 
PER|PERAMBUR
PERN|PERNEM
PES|PHESAR
PFM|PHAPHAMAU 
PFR|PACHOR ROAD
PFT|POTHAHI
PG|PERGAON
PGA|PAGARA
PGI|PARPANANGADI
PGK|PILI BANGAN
PGL|PAGDHAL
PGR|PUGALUR
PGRL|PIDUGURALLA
PGT|PALAKKAD
PGTN|PALGHAT TOWN
PGW|PHAGWARA 
PHA|PATHARIA
PHD|PHAPHUND
PHK|PUNARAKH
PHN|POKHRAYAN
PHQ|PARDHANDE
PHR|PHILLAUR 
PIA|PIPRAIGAON
PIO|PILOL
PIP|PIPLIA
PIZ|PINGLI
PJ|PEPPEGANJ
P|PANJHAN
PK|PAKNI
PKA|PRADHANKHUNTA
PKD|PENUKONDA
PKE|PIMPAR KHED
PKF|POKLA
PKO|PALAKOLLU
PKR|PAKAUR
PKRD|PAKARA ROAD
PKT|PATTUKOTTAI
PKU|PANSKURA
PKW|PILKHUA
PLC|PHALODI
PLG|PALGHAR
PLI|PETTAIVAYATALAI
PLJ|PALEJ
PLJE|PHULWARTANR
PLK|PALIA KALAN
PLMD|PILAMEDU
PLO|PULGAON 
PLP|PHULPUR
PLSN|PALSANA
PLV|PALSI
PLY|PLASSEY
PM|PALAM
PMK|PARAMAKKUDI
PMKT|PIMPALKHUTI
PML|PAPANASAM
PMN|PAMAN
PMO|PANDOLI
PMP|PIMPRI
PMR|PITAMBARPUR
PMT|PULLAMPET
PMU|PARMANANDPUR
PMY|PALI MARWAR
PNBE|PATNA 
PNC|PATNA SAHEB
PND|PENDRA ROAD
PNDM|PENNADAM
PNE|PRANTIK
PNF|PANGAON
PNHI|PANHAI
PNK|PANKI
PNME|PARASNATH
PNP|PANIPAT 
PNQ|PUNKUNNAM
PNSA|PUNSIA
PNU|PALANPUR 
PNV|PANEVADI
PNVL|PANVEL
PNW|PUNDHAG
PNYA|PANIYA HAWA
POK|POKRAN
POZ|POTUL
PP|PURANPUR
PPA|PIPRA
PPC|PIPRAICH
PPD|PIPLOD 
PPI|PIPARIYA
PPJ|POPHLAJ
PPN|PUNPUN
PPO|PANPOSH
PPR|PIPAR ROAD 
PPT|PIRPAINTI
PPU|PIPARPUR
PPZ|PEDDEMPET
PQE|PAWAPURI ROAD
PQL|PINDLAI
PQN|PWN KLAKNDER RD
PRB|PARBATI
PRDL|PARADOL
PRDP|PARADEEP
PRF|PARSIPUR
PRG|PRAYAG
PRH|POWERPET
PRI|PATHRI
PRKH|PARKANHATTI
PRLI|PARLI VAIATH
PRNA|PURNIA 
PRP|PAHARPUR
PRR|PURULIA 
PRWD|PAREWADI
PRY|PARAIYA
PS|PARAS
PSA|PALASA
PSB|PARSABAD
PSD|PARSODA
PSLI|PARSOLI
PSR|PASRAHA
PTA|PATIALA
PTB|PATTAMBI
PTH|PATRANGA
PTHD|PATOHAN
PTI|PATIALI
PTJ|PODANUR 
PTK|PATHANKOT
PTKP|POTKAPALLI
PTLI|PATHAULI
PTRD|PATAUDI ROAD
PTRE|PATARA
PTRU|PATRATU
PTU|PARTUR
PTWA|PATWARA
PU|PATCHUR
PUK|PUDUKAD
PUL|RAMPURA PHUL
PUN|PUNDI
PUNE|PUNE 
PURI|PURI
PUS|PHUSRO
PUT|PUTTUR
PUV|PUSA ROAD
PUX|PARASIA
PVD|PEDDAVADIAPUDI
PVI|PERAVURANI
PVP|PARVATIPURAM
PVPT|PARVATIPURAM TN
PVR|PANDHARPUR
PVRD|PIRAVAM ROAD
PVU|PARAVUR
PWL|PALWAL
PWS|PHULWANI SHARIF
PYD|PALLIYADI
PYOL|PAYYOLI
QLD|QUILANDI
QLM|KULEM
QLN|QUILON 
QRP|KILA RAIPUR
QSR|KANSRAO
RAA|BARARA
RAG|RAIGIR
RAIR|RAIKAKHOL
RAJP|RAJAPUR ROAD
RAKL|RETHORAKALAN
RANI|RANI
RAY|RAY
RBA|RAMBHA
RBD|RAHIMABAD
RBG|RAYBAG
RBGJ|ROBERTS GANJ
RBK|REOTI B KHERA
RBL|RAE BARELI 
RBS|RUPBAS
RBZ|RAMBHADDARPUR
RC|RAICHUR
RCTC|RAGHUNATHPUR HALT
RDDE|RATHDHANA
RDE|RUNDHI
RDHP|RADHANPUR
RDL|RUDAULI
RDM|RAMGUNDAM
RDN|DUDAIN
RDP|RADHIKAPUR
RDRA|RAMDEVRA
RDT|RAVTHA ROAD
RDUM|RAMPUR DUMRA
RE|REWARI
RECH|RECHNI ROAD
REI|RITHI
RET|RENTIA
REWA|REWA O A
RFJ|RAFIGANJ
RG|RAJGHAT NARORA
RGD|RAJGIR
RGDA|RAYAGADA
RGH|RAMGARHWA
RGJ|RAIGANJ
RGL|RENGALI
RGO|ROTEGAON
RGP|RAGHUNATHPALLI
RGPM|RAGHAVAPURAM
RGS|RINGAS 
RGU|RAGAUL
RHA|RANAGHAT 
RHE|RAKHA MINES
RHG|RAJGARH
RHMA|RAHAMA
RHNE|ROHINI
RIG|RAIGARH
RJA|RAJANAGAR
RJG|RAJGRAM
RJK|RAJA KA SAHASPR
RJP|RAZAMPETA
RJPB|RAJENDRA NAGAR (BIHA
RJPM|RAJAPALAYAM
RJT|RAJKOT 
RJU|RAJULA CITY
RJW|RAJEVADI
RJY|RAJAMUNDRY
RK|ROORKEE
RKB|RAIKA BAGH
RKD|RUKADI
RKM|RAJA KI MANDI
RKSH|RISHIKESH
RKSN|RAJKHARSAWAN 
RLA|RAJULA 
RLK|ROHAL KHURD
RLO|RAYALCHERUVU
RM|RAJMANE
RMA|RAMGANJ MANDI
RMC|RAM CHAURA ROAD
RMD|RAMANATHAPURAM
RMGM|RAMANAGARAM
RMJK|RAM NAGAR
RMM|RAMESWARAM
RMN|RAMAN
RMNP|RAMANNAPET
RMP|RAHIMATPUR
RMR|RAMNAGAR
RMRB|RAMNAGAR BENGAL
RMT|RAMGARH CANT
RMU|RAMPUR
RN|RATNAGIRI
RNC|RANCHI
RNE|RANJANI
RNG|RANIGANJ
RNGG|RANGALITING
RNH|RUNKHERA
RNIS|RANOLISHISHU
RNJD|RANJANGAON RD
RNKA|RUNKUTA
RNO|RANOLI
RNPR|RUPNARAYANPUR
RNQ|RENUKUT
RNR|RANIBENNUR
RNT|RANTHAMBHORE
RNY|RANGIYA 
ROA|RUSERA GHAT
ROHA|ROHA
ROI|REOTI
ROK|ROHTAK 
ROP|RUPSA 
ROU|ROURKELA
ROZA|ROZA 
RPAN|RANGAPARA NORTH
RPAR|RUPNAGAR
RPD|RUPAUND
RPH|RAMPUR HAT
RPJ|RAJPURA 
RPMN|RAMPURMANI HARAN
RPO|RAWATPUR
RPR|RAGHUNATHPUR
RPRD|RUPRA ROAD
RPUR|RATANPUR
RPZ|RANAPRATAPNAGAR
RQJ|RNINGR JLPAIGRI
RRB|BIRUR 
RRI|RAHURI
RRME|RANCHI ROAD
RS|RISIA
RSH|RATAN SHAHR
RSI|RAISI
RSR|RASRA
RSYI|RASAYANI
RTA|RUTHIYAI
RTGN|RATANGAON
RTI|RAOTI
RTM|RATLAM 
RTP|RATANPURA
RTZ|RATONA
RU|RENIGUNTA 
RUB|RASULABAD
RUL|RAVLI
RUM|RUPAMAU
RUPC|RUDRAPUR CITY
RUR|RANPUR
RURA|RURA
RV|RAVER
RVK|RAJA BHAT KHAWA
RVKH|RAVINDRAKHANI
RWH|ROWRIAH SDG
RWJ|RAWANIA DUNGAR
RWL|RAIWALA
RWO|RANAVAV
RXL|RAXUAL 
RYP|RAYANAPAD
RYS|RASURIYA
S|SHRIRANGAPATNA
SA|SALEM 
SAA|SATHIAON
SAC|SANICHARA
SAE|SIMARIA
SAG|SANGRUR
SAGR|SHRIRAAGAR
SAH|SAPHALE
SAHI|SATHI
SAI|SARAI
SALE|SALAR
SAN|SANDILA
SANR|SARDARNAGAR
SAO|SAGONI
SAP|SATTENAPALLE
SAS|SHDSPRA PADMPRA
SASN|SAHIBZADA ASNGR
SAT|SANT ROAD
SAU|SANAND
SAV|SAVDA
SAW|SURIAWAN
SAZ|SAMNI
SBB|SAHIBABAD
SBC|BANGALORE CY 
SBD|SLEEMANABAD RD
SBE|SORBHOG 
SBG|SAHIBGANJ 
SBH|SULEBHAVI
SBHR|SUBRAHMANYA ROAD
SBI|SABARMATI 
SBLT|SHRIBDRYA LATHI
SBM|SONBARSA KCHERI
SBO|SABAUR
SBP|SAMBALPUR
SBPD|SAMBALPUR ROAD
SBPY|SAMBALPUR CITY
SBR|SAMBHAR LAKE
SBRA|SARBAHARA
SBT|SABARMATI 
SBV|S BHAKHTIYARPUR
SBZ|SISWA BAZAR
SC|SECUNDERABAD 
SCC|SITAPUR CANT
SCH|SACHIN
SCI|SANCHI
SCKR|SALICHAUKA ROAD
SCL|SILCHAR
SCM|SIMHACHALAM
SCN|SONDHA ROAD
SCO|SATUNA
SCQ|SHAM CHAURASI
SCT|SENGOTTAI
SD|SIDHAULI
SDAH|SEALDAH
SDB|SHAHABAD
SDBH|SINDRI B.H
SDE|SADISOPUR
SDGM|SARARGRAM
SDI|SAGARDIGHI
SDL|SHAHDOL
SDLP|SADULPUR 
SDMD|SUDAMDIH
SDMK|SIDMUKH
SDN|SHOLAVANDAN
SDNR|SEYDUNGANALLUR
SDPN|SINDPAN
SDS|SADULSHAHR
SDT|SADAL
SEB|SON NAGAR
SED|SHEDBAL
SEE|SONPUR 
SEG|SHEGAON
SEGM|SEVAGRAM
SEH|SEHORE
SELU|SELU
SEM|SERAM
SEO|SEOHARA
SEU|SENDRA
SFC|SAINTALA
SFG|SUBEDARGANJ
SFH|SAFEDABAD
SFM|SUNAM
SFW|SARANGPUR
SFY|SHAJAPUR
SGAM|SAREIGRAM
SGBJ|SURGAON BANJARI
SGD|SONGADH
SGDM|SIGADAM
SGE|SANKARIDRUG
SGF|SANGAT
SGG|SULTANGANJ
SGJ|SAFDARGANJ
SGL|SAGAULI 
SGND|SHRIGONDA ROAD
SGNR|SHRI GANGANAGAR
SGO|SAUGOR
SGP|SOHAGPUR
SGR|SANGMESHWAR
SGRA|SANGARIA
SGRL|SINGRAULI
SGRM|SINGARAM
SGUJ|SILIGURI 
SGUT|SILIGURU TOWN
SGZ|SHAMGARH
SHAD|SHAHAD
SHC|SAHARSA 
SHDM|SHAHBAD MARKNDA
SHDR|SHADHORAGAON
SHE|SEORAPHULI
SHF|SHIRUD
SHG|SHAHGANJ 
SHIV|SHINDAWANE
SHK|SHEIKPURA
SHLK|SHOLAKA
SHM|SHALIMAR
SHNG|SHIVNAGAR
SHNR|SHADNAGAR
SHR|SIHORA ROAD
SHSK|SAHARSRAKUND
SHU|SHOLINGHUR
SI|SONALLI
SID|SIDDHPUR
SIHO|SIHO
SIKR|SIKAR 
SIL|SAKHI GOPAL
SILO|SILAO
SINI|SINI 
SIOB|SAMAKHIALI B G
SIP|SURAIMANPUR
SIPR|SIHAPAR
SIQ|SARKONI
SIR|SIRHIND 
SIRD|SIRD
SIW|SHIRRAVDE
SP|SUJANPUR
SJP|SHUJALPUR
SJQ|SURAJPUR ROAD
SJT|SHUJAATPUR
SKA|SIKANDRA RAO
SKB|SHIKOHABAD 
SKGH|SAKTESGARH
SKI|SAKRI 
SKJ|SAHIBPUR KML 
SKLR|SAKLESHPUR
SKM|SINGARAYAKONDA
SKN|SRIKRISHN NAGAR
SKND|SUKINDA ROAD
SKP|SHANKARPALLI
SKPI|SIKRIPAI
SKPT|SOMANAYAKKANPTI
SKR|SAKHPUR
SKS|SALEKASA
SKT|SAKTI
SKTN|SHAKTINAGAR
SKY|SHIKARA
SKZR|SIRPUR KAGAZNGR
SL|SURATHKAL
SLB|SALBONI
SLD|SAKALDIHA
SLF|SILLI
SLGH|SHELGOAN H
SLGR|SIMALUGURI 
SLHA|SALHANA
SLI|SANGLI
SLJ|SAKRIGALI 
SLKR|SALKA ROAD
SLN|SULTANPUR
SLNA|SALAUNA
SLO|SAMALKOT 
SLOR|SELOO ROAD
SLP|SALPA
SLT|SILAUT
SLW|SOHWAL
SLY|SAMALPATTI
SM|SAMSI
SMBJ|SHRI MAHABIRJI
SMBL|SIMBHOOLI
SMBX|SAMBA
SMC|SAMNAPUR
SME|SHIMOGA
SMET|SHIMOGA TOWN
SMI|SITAMARHI
SMK|SAMALKHA
SMLA|SAMLAYA 
SMNE|SOMATNE
SMNH|SOMNATH
SMO|SEMAPUR
SMP|SHAMBHUPURA
SMPA|SHYAMPURA
SMPR|SHRI MADHOPUR
SMQL|SHAMLI
SMR|SAMDHARI 
SMRR|SUMRERI
SMT|SALAMATPUR
SMZ|SARAI MIR
SNDD|SINDHU DURG
SNE|SHENOLI
SNF|SANAT NAGAR
SNGN|SANGANER
SNGP|SINGHPUR
SNI|SINDI
SNK|SINDKHEDA
SNKB|SONKHAMB
SNKL|SANKARANKOVIL
SNL|SANAHWAL
SNLR|SANTALPUR
SNN|SONEGAON
SNP|SONIPAT
SNPR|SINGARPUR
SNRR|SANSARPUR
SNSI|SAINAGAR SIRIDI
SNT|SAINTHIA
SNTD|SANTALDIH
SNV|SONDAD
SNVR|SANVATSAR
SNX|SANEH ROAD
SOD|SOJAT ROAD
SOG|SURATGARH 
SOH|SIROHI ROAD
SO|SIHOR GUJARAT
SONI|SONI
SOP|SHIUPUR
SOR|SONAGIR
SORO|SORO
SOS|SOMESAR
SOT|SHOHRATGARH
SPC|SITAPUR CITY
SPDR|SHEOPAARSAD NAGAR
SPE|SULLURUPETA
SPJ|SAMASTIPUR 
SPK|SAPEKHATI
SPN|SHAHJEHANPUR
SPP|SHAHPUR PATOREE
SPRD|SINGAPURAM ROAD
SPT|SOMPETA
SPZ|SAMPLA
SQE|SAMRLA
SQL|SONTALAI
SQN|SARAI KANSRAI
SQR|SULTANPUR LODI
SRAS|SIRAS
SRBA|SARAGBUNDIA
SRC|SANTRAGACHI 
SRE|SAHARANPUR
SRGH|SURAJGARH
SRGM|SRIRANGAM
SRGT|SURENDRANAGAR G
SRI|SALMARI
SRID|SRIDHAM
SRJ|SHANKARGARH
SRKI|SEMARKHERI
SRL|SAROLA
SRNK|SORON SHUKARKSHETRA
SRNR|SRIRAMNAGAR
SRNT|SARNATH
SRO|SIRATHU
SRP|SERAMPORE
SRPJ|SWARUPGANJ
SRR|SHORANUR 
SRT|SATUR
SRTL|SHERTALAI
SRTN|SIBSAGAR TOWN
SRU|SALEMPUR 
SRUR|SIRPUR TOWN
SRY|SIRARI
SS|SHIRSOLI
SSA|SIRSA
SSB|SHAKURBASTI
SSD|SHAMSABAD
SSIA|SUISA
SSM|SASARAM
SSPN|SAI P NILAYAM
SSR|SARERI
SSV|SASVAD ROAD
ST|SURAT
STA|SATNA
STBJ|SITABINJ
STD|SATROD
STJT|SATHAJAGAT
STKT|SASTHANKOTTA
STL|SIMULTALA
STLR|SITALPUR
STN|SITARAMPUR
STP|SITAPUR
STPD|SITAFAL MANDI
STR|SATARA
STW|SAHATWAR
SUA|SARDIHA
SUD|SUDHANI
SUJR|SUJRA
SUL|SULADHAL
SUM|SUMMIT
SUMR|SUMER
SUNR|SURENDRANAGAR
SUR|SOLAPUR 
SURI|SIURI
SUW|SUKHISEWANIYAN
SV|SIWAN 
SVA|SUWASRA
SVD|SARWARI
SVGA|SIVAGANGA
SVHE|SISVINHALLI
SVJR|SIVAJINAGAR
SVKD|SAVARKUNDLA
SVKS|SIVAKASI
SVM|SANVERDAM CHUCH
SVN|SIVUNGAON
SVPI|SHIVPURI
SVPR|SRIVILLIPUTTUR
SVRP|SHIVANARAYANPUR
SVV|SRIVAIKUNTAM
SWA|SAHJANWA
SWC|SHIVRAMPUR
SWE|SIWAITH
SWM|SAWAI MADHOPUR
SWPR|SEWAPURI
SWR|SONUA
SWRT|SAHAWAR TOWN
SWV|SAWANTWADI ROAD
SXB|SAMBRE
SXF|SOBHAPUR
SXT|SALEM TOWN
SY|SIRKAZHI
SYA|SALAIA
SYC|SARAI CHANDI
SYJ|SAIDRAJA
SYL|SALPURA
SYN|SAYAN
SYWN|SAIYID SARAWAN
SZM|SUBZI MANDI
SZR|SARUPATHAR
TA|TANUR
TAE|TADALI
TAN|TARANA ROAD
TAPA|TAPA
TATA|TATANAGAR 
TAZ|TARGAON
TBM|TAMBARAM
TBN|TIMARNI
TBT|TALBAHAT
TCL|TYAKAL
TCN|TIRUCHENDUR
TCR|TRICHUR
TDD|TADEPALLIGUDEM
TDL|TUNDLA 
TDN|TIRUPARANKNDRM
TDO|TANDA URMAR
TDP|TODARPUR
TDPR|TIRUPADRIPULYUR
TDU|TANDUR
TEA|TAREGNA
TEL|TENALI 
TELO|TELO
TEN|TIRUNELVELI
TEO|TEEGAON
TET|TETULMARI
TETA|TELTA
TGA|TEGHRA
TGN|TALEGAON
TGP|TULJAPUR
TGQ|TENGANMADA
TGT|TINAI GHAT
TGU|TARIGOPPULA
THA|TEHTA
THAN|THAN 
THB|THANA BIHPUR 
THDR|THANDLA RD
THEA|THALERA
THL|TIRUVALAM
THUR|THURIA
THV|THERUBALI
THVM|THIVIM
TIA|TILAYA
TIG|TITLAGARH
TIHU|TIHU
TIR|TIRUR
TIS|TATISILWAI
TIU|TILARU
TJ|THANJAVAR
TK|TUMKUR
TKBG|TEKA BIGHA(H)
TKD|TUGLAKABAD
TKE|TARIKERE 
TKI|TAKLI
TKJ|TILAK BRIDGE
TKMY|TAKLIMIYA HALT
TKN|TANKUPPA
TKQ|TRIKARPUR
TKR|TAKARI
TKRI|TIKIRI
TKYR|TIKARIA
TL|TILONIYA
TLA|TITVALA
TLD|TILDA
TLH|TILHAR
TLHD|TALCHER ROAD
TLHR|TALCHER
TLJ|TALJHARI
TLKH|TALAKHAJURI
TLN|TALNI
TLR|TULSIPUR
TLU|TARLUPADU
TLV|TALVADYA
TLY|TELLICHERRY
TLZ|TALAVLI
TME|TUTI MELUR
TMKA|TOMKA
TMQ|TIRUMANGALAM
TMR|TUMSAR ROAD
TMT|TIMTALA
TMV|TINDIVANAM
TMX|TIMMAPUR
TMZ|TAMLUK
TN|TUTICORIN
TNA|THANE
TNGL|TORANAGALLU
TNH|TINKHEDA
TNKU|TANUKU
TNR|TANGUTURU
TORI|TORI
TP|TIRCHRPALI FORT
TPH|TINPAHAR 
TPJ|TIRUCHCHIRAPALI
TPND|TALOJA PANCHAND
TPT|TIRUPATTUR 
TPTN|TIRUCHRPALI TWN
TPTY|TIRUPATI
TPZ|TAPRI
TQA|TAKIA
TQN|TIKUNIA
TRAN|TORANG
TRB|TIRUVERUMBUR
TRL|TRIVELLORE
TRO|TIRORA
TRR|TARAORI
TRS|TARSARAI
TRT|TIRUTTANI
TRTR|TRIUPUNITTURA
TRVL|TIRUVALLA
TSA|TISUA
TSD|TAHSIL BHADRA
TSF|TAHSIL FATEHPUR
TSI|TENKASI 
TSK|TINSUKIA 
TSR|TSUNDURU
TTB|TITABAR
TTL|TIRUTTANGAL
TTP|TIRUTURAIPDI 
TTR|TIPTUR
TU|TADIPATRI
TUA|TIRUNNAVAYA
TUG|THALANGAI
TUL|TIRALDIH
TUN|TOHANA
TUNI|TUNI
TUP|TIRUPPUR
TUVR|TURAVUR
TVC|TRIVANDRUM CNTL
TVG|TAVARGATTI
TVL|TADWAL
TVP|TRIVANDRUM PETT
TVR|THIRUVARUR 
TWB|TALWANDI
TWG|TWINING GANJ
TZR|TURKI ROAD
UAA|UPPALA
UBC|AMBALA CITY
UBL|HUBLI 
UBR|UMBARGAM ROAD
UCA|UCHANA
UCR|UNCHAHAR 
UD|UDUPI
UDGR|UDGIR
UDL|ANDAL 
UDM|UNDASA MADHAWPU
UDN|UDHNA 
UDR|AMDARA
UDZ|UDAIPUR
UGN|UGAON
UGR|UGAR KHURD
UHL|UNA HIMACHAL
UHP|UDHAMPUR
UHR|UNCHHERA
UJA|UNJHA
UJH|UJHANI
UJP|UJIARPUR
UKA|UKHRA
UKL|UTTUKULI
UKR|UDALKACHAR
ULB|ULUBARIA
ULD|ACHALDA
ULL|ULLAL
ULNR|ULHASNAGAR
ULT|KULTI
UMB|AMBALA CANT 
UMD|UMED
UMN|AMBLIYASAN
UMR|UMARIA
UMRI|UMRI
UNK|UNKAL
UOI|UMROLI
UPR|USMANPUR
UR|UMDANAGAR
URD|UNTARE ROAD
UREN|UREN
URGA|URGA
URI|URULI
URL|UNJALUR
URPR|UGRASENPUR
USL|USALAPUR
USRA|USRA
UTA|UMAR TALI
UTL|UTARLAI
UTR|UTRAHTIA
UVD|UDVADA
VAA|BHAGA 
VAK|VARKALA
VAPI|VAPI
VAPM|VALAPATTANAM
VARD|VALKAM ROAD
VBL|BOBBILI
VBR|VAMBORI
VBW|VAIBHAVWADI ROAD
VDA|VASAD 
VDD|VENDODU
VDE|VEDAYAPALEM
VDN|VADGAON
VDS|VIDYASAGAR
VEER|VEER
VG|VIRAMGAM 
VGE|VALAPPADI G HLT
VGL|VAGHLI
VGN|VANGAON
VHGN|WIHIRGAON
VI|VILLIANUR
VID|VILAVADE
VJP|VIJALPUR
VJPJ|VIJIYPUR JAMMU
VJR|VIJAYANAGAR
VKA|VERKA 
VKB|VIKARABAD 
VKI|VENKATAGIRI
VKN|VINUKONDA
VKR|VENKATNAGRA
VL|VILAD
VLI|VALLIKUNNU
VLT|VALATHOOR
VLY|VALLIYUR
VM|VILLUPARAM 
VMA|VIKRAMGARH ALOT
VMD|VADLAMANNADU
VN|VANIYAMBADI
VNA|VARANGAON
VNUP|VISHNUPURAM
VPN|VIDYAPATINAGAR
VPO|BHUPIA MAU
VPR|VISAPUR
VPT|VIRUDUNAGAR 
VR|VIRAR
VRB|VISHRAMBAG
VRBD|VRINDABAN ROAD
VRG|VIKRAMNAGAR
VRH|VIRBHADRA
VRI|VRIDHACHALAM 
VRL|VERAVAL
VRR|VIRPUR
VRX|VARAHI
VS|VISHVAMITRI
VSD|VASIND
VSG|VASCO DA GAMA
VSKP|VISHAKAPATNAM
VSP|WASANAPURA
VST|BIJAYSOTA
VSU|BISHNUPUR
VTM|VETAPALEMU
VTN|VAITARNA
VV|VALIVADE
VVB|VIVEKA VIHAR
VVM|VIRAVASARAM
VYA|VYARA
VYK|VILAYATKALAN RD
VYN|VYASNAGAR
VZM|VIZIANAGRAM 
WADI|WADI
WANI|WANI
WC|WADHWAN CITY
WDM|WYNDHAMGANJ
WDR|WADIARAM
WDS|WADSINGE
WENA|WENA
WFD|WHITEFIELD
WGA|WAGHODA
WHM|WASHIM
WIRR|WIRUR
WJR|WALAJAH ROAD 
WKA|VAKAV
WKI|WADAKANCHERI
WKR|WANKANER 
WL|WARANGAL
WLH|VALHA
WNG|WANEGAON
WPR|WANPARTI ROAD
WR|WARDHA 
WRR|WARORA
WRS|WARIS ALEGANJ
WSA|WADSA
WSB|WASHIMBE
WSC|SHIVARAMPUR
WSJ|WANSJALIYA
WTJ|JAM WANTHALI
WTR|WATHAR
WZJ|WAZERGANJ
YA|YERRAGUNTLA
YAD|YEULKHED
YFP|YUSUFPUR
YG|YADGIR
YL|YEOLA
YLM|ELAMANCHILI
YNK|YELAHANKA .
YP|ERRUPALEM
YPR|YASVANTPUR 
YT|YEVAT
ZB|ZAHIRABAD
ZBD|ZAFARABAD 
ZN|JANGAON
ZNA|ZAMANIA
ZRDE|JIRADEI
ZW|ZAWAR
RJN|Random Station 0
ALJN|Random Station 1
BRJN|Random Station 2
AJNI|Random Station 3
CJN|Random Station 4
JNH|Random Station 5
JNA|Random Station 6
JNU|Random Station 7
LJN|Random Station 8
